R 1120 960

NO ./img/redbrick.xpm
SO ./img/bluestone.xpm
EA ./img/colorstone.xpm
WE ./img/greystone.xpm

S ./path_to_the_sprite_texture_ATTENTION_PARSING_RGB_TRASH_ET_PROBLEME_NBRS_ARGUMENTS
F 100,100,100,
C 255,0,0

111111111111111
101001S00010001
101000210000001
101000100000001
100000000000001
100000000010001
100000000010001
100000000010001
100000000011001
100001000001001
100001010001001
100001000000001
100001000000001
100000000000001
100000000002001
100000000000001
100000000000001
101000010000001
101000000000001
100000000000001
100000000010001
100000000010001
100000000010001
100000000011001
100001000001001
100001010001001
100001000000001
100001000000001
100000000000001
100000000000001
100000000000001
100000000000001
101001000010001
101000010000001
101000000000001
100000000000001
100000000010001
100000000010001
100000000010001
100000000011001
100001000001001
100001010001001
100001000000001
100001000000001
100000000000001
100000000000001
100000000000001
100000000000001
101000010000001
101000000000001
100000000000001
100000000010001
100000000010001
100000000010001
100000000011001
100001000001001
100001010001001
100001000000001
100001000000001
100000000000001
100000000000001
100000000000001
100000000000001
101001000010001
101000010000001
101000000000001
100000000000001
100000000010001
100000000010001
100000000010001
100000000011001
100001000001001
100001010001001
100001000000001
100001000000001
100000000000001
100000000000001
100000000000001
100000000000001
101000010000001
101000000000001
100000000000001
100000000010001
100000000010001
100000000010001
100000000011001
100001000001001
100001010001001
100001000000001
100001000000001
100000000000001
100000000000001
100000000000001
100000000000001
101001000010001
101000010000001
101000000000001
100000000000001
100000000010001
100000000010001
100000000010001
100000000011001
100001000001001
100001010001001
100001000000001
100001000000001
100000000000001
100000000000001
100000000000001
100000000000001
101000010000001
101000000000001
100000000000001
100000000010001
100000000010001
100000000010001
100000000011001
100001000001001
100001010001001
100001000000001
100001000000001
100000000000001
100000000000001
100000000000001
100000000000001
101001000010001
101000010000001
101000000000001
100000000000001
100000000010001
100000000010001
100000000010001
100002000011001
100001000001001
100001010001001
100001000000001
100001000000001
100000000000001
100000000000001
100000000000001
100000000000001
101000010000001
101000000000001
100000000000001
100000000010001
100000000010001
100000000010001
100000000011001
100001000001001
100001010001001
100001000000001
100001000000001
100000000000001
100000000000001
100000000000001
100000000000001
101001000010001
101000010000001
101000000000001
100000000000001
100000000010001
100000000010001
100000000010001
100000000011001
100001000001001
100001010001001
100001000000001
100001000000001
100000000000001
100000000000001
100000000000001
100000000000001
101000010000001
101000000000001
100000000000001
100000000010001
100000000010001
100000000010001
100000000011001
100001000001001
100001010001001
100001000000001
100001000000001
100000000000001
100000000000001
100000000000001
100000000000001
101001000010001
101000010000001
101000000000001
100000000000001
100000000010001
100000000010001
100000000010001
100000000011001
100001000001001
100001010001001
100001000000001
100001000000001
100000000000001
100000000000001
100000000000001
100000000000001
101000010000001
101000000000001
100000000000001
100000000010001
100000000010001
100000000010001
100000000011001
100001000001001
100001010001001
100001000000001
100001000000001
100000000000001
100000000200001
100000000000001
100000000000001
101001000010001
101000010000001
101000000000001
100000000000001
100000000010001
100000000010001
100000000010001
100000000011001
100001000001001
100001010001001
100001000000001
100001000000001
100000000000021
100000000000001
100000000000001
100000000000001
101000010000001
101000000000001
100000000000001
100000000010001
100000000010001
100000000010001
100000000011001
100001000001001
100001010001001
100001000000001
100001000000001
100000000000001
100000000000001
100000000000001
100000000000001
101001000010001
101000010000001
101000000000001
100000000000001
100000000010001
100000000010001
100000000010001
100000000011001
100001000001001
100001010001001
100001000000001
100001000000001
100000000000001
100000000000001
100000000000001
100000000000001
101000010000001
101000000000001
100000000000001
100000000010001
100000000010001
100000000010001
100000000011001
100001000001001
100001010001001
100001000000001
100001000000001
100000000000001
100000000000001
100000000000001
100000000000001
101001000010001
101000010000001
101000000000001
100000000000001
100000000010001
100000000010001
100000000010001
100000000011001
100001000001001
100001010001001
100001000000001
100001000000001
100000000000001
100000000000001
100000000000001
100000000000001
101000010000001
101000000000001
100000000000001
100000000010001
100000000010001
100000000010001
100000000011001
100001000001001
100001010001001
100001000000001
100001000000001
100000000000001
100000000000001
100000000000001
100000000000001
101001000010001
101000010000001
101000000000001
100000000000001
100000000010001
100000000010001
100000000010001
100000000011001
100001000001001
100001010001001
100001000000001
100001000000001
100000000000001
100000000000001
100000000000001
100000000000001
101000010000001
101000000000001
100000000000001
100000000010001
100000000010001
100000000010001
100000000011001
100001000001001
100001010001001
100001000000001
100001000000001
100000000000001
100000000000001
100000000000001
100000000000001
101001000010001
101000010000001
101000000000001
100000000000001
100000000010001
100000000010001
100000000010001
100000000011001
100001000001001
100001010001001
100001000000001
100001000000001
100000000000001
100000000000001
100000000000001
100000000000001
101000010000001
101000000000001
100000000000001
100000000010001
100000000010001
100000000010001
100000000011001
100001000001001
100001010001001
100001000000001
100001000000001
100000000000001
100000000000001
100000000000001
100000000000001
101001000010001
101000010000001
101000000000001
100000000000001
100000000010001
100000000010001
100000000010001
100000000011001
100001000001001
100001010001001
100001000000001
100001000000001
100000000000001
100000000000001
100000000000001
100000000000001
101000010000001
101000000000001
100000000000001
100000000010001
100000000010001
100000000010001
100000000011001
100001000001001
100001010001001
100001000000001
100001000000001
100000000000001
100000000000001
100000000000001
100000000000001
101001000010001
101000010000001
101000000000001
100000000000001
100000000010001
100000000010001
100000000010001
100000000011001
100001000001001
100001010001001
100001000000001
100001000000001
100000000000001
100000000000001
100000000000001
100000000000001
101000010000001
101000000000001
100000000000001
100000000010001
100000000010001
100000000010001
100000000011001
100001000001001
100001010001001
100001000000001
100001000000001
100000000000001
100000000000001
100000000000001
100000000000001
101001000010001
101000010000001
101000000000001
100000000000001
100000000010001
100000000010001
100000000010001
100000000011001
100001000001001
100001010001001
100001000000001
100001000000001
100000000000001
100000000000001
100000000000001
100000000000001
101000010000001
101000000000001
100000000000001
100000000010001
100000000010001
100000000010001
100000000011001
100001000001001
100001010001001
100001000000001
100001000000001
100000000000001
100000000000001
100000000000001
100000000000001
101001000010001
101000010000001
101000000000001
100000000000001
100000000010001
100000000010001
100000000010001
100000000011001
100001000001001
100001010001001
100001000000001
100001000000001
100000000000001
100000000000001
100000000000001
100000000000001
101000010000001
101000000000001
100000000000001
100000000010001
100000000010001
100000000010001
100000000011001
100001000001001
100001010001001
100001000000001
100001000000001
100000000000001
100000000000001
100000000000001
100000000000001
101001000010001
101000010000001
101000000000001
100000000000001
100000000010001
100000000010001
100000000010001
100000000011001
100001000001001
100001010001001
100001000000001
100001000000001
100000000000001
100000000000001
100000000000001
100000000000001
101000010000001
101000000000001
100000000000001
100000000010001
100000000010001
100000000010001
100000000011001
100001000001001
100001010001001
100001000000001
100001000000001
100000000000001
100000000000001
100000000000001
100000000000001
101001000010001
101000010000001
101000000000001
100000000000001
100000000010001
100000000010001
100000000010001
100000000011001
100001000001001
100001010001001
100001000000001
100001000000001
100000000000001
100000000000001
100000000000001
100000000000001
101000010000001
101000000000001
100000000000001
100000000010001
100000000010001
100000000010001
100000000011001
100001000001001
100001010001001
100001000000001
100001000000001
100000000000001
100000000000001
100000000000001
100000000000001
101001000010001
101000010000001
101000000000001
100000000000001
100000000010001
100000000010001
100000000010001
100000000011001
100001000001001
100001010001001
100001000000001
100001000000001
100000000000001
100000000000001
100000000000001
100000000000001
101000010000001
101000000000001
100000000000001
100000000010001
100000000010001
100000000010001
100000000011001
100001000001001
100001010001001
100001000000001
100001000000001
100000000000001
100000000000001
100000000000001
100000000000001
101001000010001
101000010000001
101000000000001
100000000000001
100000000010001
100000000010001
100000000010001
100000000011001
100001000001001
100001010001001
100001000000001
100001000000001
100000000000001
100000000000001
100000000000001
100000000000001
101000010000001
101000000000001
100000000000001
100000000010001
100000000010001
100000000010001
100000000011001
100001000001001
100001010001001
100001000000001
100001000000001
100000000000001
100000000000001
100000000000001
100000000000001
101001000010001
101000010000001
101000000000001
100000000000001
100000000010001
100000000010001
100000000010001
100000000011001
100001000001001
100001010001001
100001000000001
100001000000001
100000000000001
100000000000001
100000000000001
100000000000001
101000010000001
101000000000001
100000000000001
100000000010001
100000000010001
100000000010001
100000000011001
100001000001001
100001010001001
100001000000001
100001000000001
100000000000001
100000000000001
100000000000001
100000000000001
101001000010001
101000010000001
101000000000001
100000000000001
100000000010001
100000000010001
100000000010001
100000000011001
100001000001001
100001010001001
100001000000001
100001000000001
100000000000001
100000000000001
100000000000001
100000000000001
101000010000001
101000000000001
100000000000001
100000000010001
100000000010001
100000000010001
100000000011001
100001000001001
100001010001001
100001000000001
100001000000001
100000000000001
100000000000001
100000000000001
100000000000001
101001000010001
101000010000001
101000000000001
100000000000001
100000000010001
100000000010001
100000000010001
100000000011001
100001000001001
100001010001001
100001000000001
100001000000001
100000000000001
100000000000001
100000000000001
100000000000001
101000010000001
101000000000001
100000000000001
100000000010001
100000000010001
100000000010001
100000000011001
100001000001001
100001010001001
100001000000001
100001000000001
100000000000001
100000000000001
100000000000001
100000000000001
101001000010001
101000010000001
101000000000001
100000000000001
100000000010001
100000000010001
100000000010001
100000000011001
100001000001001
100001010001001
100001000000001
100001000000001
100000000000001
100000000000001
100000000000001
100000000000001
101000010000001
101000000000001
100000000000001
100000000010001
100000000010001
100000000010001
100000000011001
100001000001001
100001010001001
100001000000001
100001000000001
100000000000001
100000000000001
100000000000001
100000000000001
111111111111111
         



11111