R 1120 960

NO ./img/redbrick.xpm
SO ./img/bluestone.xpm
EA ./img/colorstone.xpm
WE ./img/greystone.xpm

S ./img/ghost.xpm
F 100,100,100
C 255,0,0







111111111111111
121011111110021
10101     10001
101011111112001
100000000E00001
111111111111111
 
 
  
 
 
1