R 1120 960

NO ./img/redbrick.xpm
SO ./img/bluestone.xpm
EA ./img/colorstone.xpm
WE ./img/greystone.xpm

S ./path_to_the_sprite_texture_ATTENTION_PARSING_RGB_TRASH_ET_PROBLEME_NBRS_ARGUMENTS
F 100,100,100,
C 255,0,0

111111111111111
121001S20010001
101000210000001
101000100002001
100000000000021
111111111111111