R 1120 960

NO ./img/redbrick.xpm
SO ./img/bluestone.xpm
EA ./img/colorstone.xpm
WE ./img/greystone.xpm

S ./img/ghost.xpm
F 250,100,0
C 225,30,0

111111
110N01111
1111111
121
1111111111
1100000001
100000111
111111111
