R 1120 960

NO ./img/barrel.xpm
SO ./img/barrel.xpm
EA ./img/barrel.xpm
WE ./img/barrel.xpm

S ./img/barrel.xpm
F 100,100,100
C 100,200,30

111111111111111
101001S00010001
101000210000001
101000100000001
100000000000001
100000000010001
111111111111111