NO img/redbrick.xpm
SO img/greystone.xpm
EA img/bluestone.xpm
WE img/barrel.xpm
S img/barrel.xpm
R 100 100
F 123,123,123
C 123,123,113

11111111111111
1N2002002002001
11111111111111