NO /Users/ijacquet/Documents/Current/cub3d/Cub3D/img/beauté.xpm
SO img/barrel.xpm
WE img/barrel.xpm
EA img/barrel
S img/barrel.xpm
F 0,0,0
C 0,0,4294967296

R 690 420


111111111111111111111111111111
10000000000000000001
100000000000000000001
10000000000N000000001
100000000000000200001
100000000000000000001
111111111111111111111