NO /Users/ijacquet/Documents/Current/cub3d/Cub3D/img/beauté.xpm
SO img/barrel.xpm
WE img/joyjoy.xpm
EA img/dodo.xpm
S img/nico.xpm
F 170,170,0
C 123,69,21

R 5160 2880


111111111111111111111111111111
10000000000000000001
100000000000000000001
10000000000N002200001
100000000000002200001
100000000000000000001
111111111111111111111